type none
height 8
width 8
@@@@@@@@
@......@
@......@
@@@@...@
@@@@...@
@@@@...@
@@....@@
@@@@@@@@